 	_
ю	iu
А	A
н	n
д	d
е	e
р	r
с	s
о	o
а	a
ф	f
б	b
і	i
я	ia
Б	B
ж	zh
и	y
ч	ch
т	t
л	l
з	z
у	u
м	m
к	k
В	V
й	j
ь	'
Ь	'
г	h
Г	H
И	Y
п	p
в	v
Д	D
х	kh
Р	R
К	K
є	ie
ц	ts
Л	L
З	Z
ш	sh
М	M
П	P
Н	N
У	U
ї	ji
О	O
С	S
Є	Ie
Т	T
Х	Kh
Ф	F
Ю	Iu
щ	shch
Ч	Ch
Ж	Zh
Ш	Sh
–	-
Й	J
І	I
ы	y
Е	E
Щ	Shch
Я	Ia
ё	io
Ц	Ts
ü	ue
#	sharp
Э	E
Š	Sh
Ї	Ji
ї	ji